11111111
1CCC1111
1CP1C111
1CCCEC11
1CCCC1C1
11111111
