111111111111111111
10E100000100000001
100001111111111001
100011000000100001
10C001000011111101
100000000010000001
100000P00000000001
111111111111111111