11111111111111
1C000000100001
100000001C0001
11011100101101
1E000C000010P1
10000000000001
11111111111111