11111111111111
1P0000000C0001
10000000000001
11011100001111
1E000000001111
11111111111111