111111111111111111
10E100000100000001
100001111111111001
100011000000100001
10C001011111111101
100000000C10000001
100000P000000C0001
111111111111111111